Constellation	KEYWORD1 
MessageSender	KEYWORD1
MessageContext	KEYWORD1
ScopeType	KEYWORD1
Group	KEYWORD2
Package	KEYWORD2
Sentinel	KEYWORD2
Other	KEYWORD2
All	KEYWORD2
LogLevel KEYWORD1
SenderType KEYWORD1
DescriptorType KEYWORD1
MemberInfo	KEYWORD1
getSentinelName	KEYWORD2
getPackageName	KEYWORD2
DebugMode	KEYWORD1
Off	KEYWORD2
Error	KEYWORD2
Info	KEYWORD2
Debug	KEYWORD2
Trace	KEYWORD2
checkIncomingMessage	KEYWORD2
checkStateObjectUpdate	KEYWORD2
subscribeToMessage	KEYWORD2
subscribeToGroup	KEYWORD2
registerMessageCallback	KEYWORD2
addMessageCallbackType	KEYWORD2
addStateObjectType	KEYWORD2
declarePackageDescriptor	KEYWORD2
subscribeToStateObjects	KEYWORD2
requestStateObjects	KEYWORD2
registerStateObjectLink	KEYWORD2
getSettings	KEYWORD2
sendMessage	KEYWORD2
sendMessageWithSaga	KEYWORD2
sendResponse	KEYWORD2
pushStateObject	KEYWORD2
purgeStateObjects	KEYWORD2
writeInfo	KEYWORD2
writeWarn	KEYWORD2
writeError	KEYWORD2
writeLog	KEYWORD2
setServer	KEYWORD2
setIdentity	KEYWORD2
setMessageReceiveCallback	KEYWORD2
setStateObjectUpdateCallback	KEYWORD2
setDebugMode	KEYWORD2
onClientConnected	KEYWORD2
setAuthorization	KEYWORD2
setUserAgent	KEYWORD2
setTimeout	KEYWORD2
stringFormat	KEYWORD2
MessageCallbackDescriptor	KEYWORD1
TypeDescriptor	KEYWORD1
fillJsonObject	KEYWORD2
empty	KEYWORD2
setDescription	KEYWORD2
setHidden	KEYWORD2
setReturnType	KEYWORD2
addParameter	KEYWORD2
addOptionalParameter	KEYWORD2
addProperty	KEYWORD2
BufferedPrint	KEYWORD1
write	KEYWORD2
flush	KEYWORD2